#########################
#.......................#
#.###.#..#######..#.###.#
#.# #.#...........#.# #.#
#.###.#..#.....#..#.###.#
#.....#..#.....#..#.....#
#.#####...........#####.#
#.#...................#.#
#...########.########...#
#.......................#
#.#######.#####.######..#
#.........#   #.........#
#.........#####.........#
#.###...............###.#
#.# #...............# #.#
#.###.#....###....#.###.#
#.....#...........#.....#
#.#####....###....#####.#
#.......................#
#########################
