#########################
#...........#...........#
#.#####.###.#.###.#####.#
#.......................#
#.#####.#.#####.#.#####.#
#.......#...#...#.......#
#######.###.#.###.#######
#     #.#.......#.#     #
#######.#.## ##.#.#######
#.........#   #.........#
#######.#.#   #.#.#######
#######.#.#####.#.#######
#     #.#.......#.#     #
#######.###.#.###.#######
#.......#...#...#.......#
#.#####.#.#####.#.#####.#
#........... ...........#
#.#####.###.#.###.#####.#
#...........#...........#
#########################